111111
1P0001
1E1001
1C1001
111111
