111111
1C1011
101001
1E00P1
111111