111111
1C1C11
1C1CC1
1ECCP1
111111