111111
101011
100001
1EC0P1
111111