111111
100011
1C0P11
1E11v1
111111